2222222222222222
2222222222222222
2200000000000022
2200000100000022
2200000122000022
2200000000000022
2200000000000022
2200000000000022
2200000000000022
2200000000000022
2222222222222222
2222222222222222