10 11 11 11 10 10 10 10 10 10 10 10 10 10 10 10 11 12 12 11 10 10 10 10 10 10 11 10 10 10 10 11 12 12 11 10 10 10 10 10 10 11 12 12 11 10 10 10 10 10
11 11 11 10 10 10 10 10 10 10 10 10 10 10 10 10 11 12 11 11 10 10 10 10 10 11 11 11 10 10 11 11 12 11 10 10 10 10 10 10 10 11 12 11 10 10 10 10 10 10
11 11 11 10 10 10 10 10 10 10 10 10 10 10 10 10 10 10 10 10 10 10 10 10 11 11 11 11 11 11 11 11 11 10 10 10 10 10 10 10 11 11 12 12 11 10 10 10 10 10
11 10 10 10 10 10 10 10 10 10 10 10 10 10 10 10 10 10 10 10 10 10 10 11 11 11 11 11 11 11 11 10 10 10 10 10 10 10 10 11 11 11 12 12 11 10 10 10 10 10
10 10 10 10 10 10 10 10 10 10 10 10 11 10 10 10 10 10 10 10 10 10 11 12 11 10 10 10 10 11 10 10 10 10 10 10 11 11 11 11 11 11 12 12 11 11 10 10 10 10
10 10 10 10 10 10 10 10 10 10 10 11 11 11 10 10 10 10 10 10 10 11 12 12 11 10 10 10 10 11 10 10 10 10 10 10 11 11 11 10 10 10 11 11 11 10 10 10 10 10
10 10 10 10 10 11 10 10 10 10 10 11 11 11 11 11 10 10 10 10 11 12 12 12 11 10 10 10 10 11 10 10 10 10 10 10 11 11 10 10 10 10 10 10 10 10 10 10 10 10
10 10 10 10 10 10 10 10 10 10 10 10 11 11 11 10 10 10 10 11 11 11 11 11 10 10 10 10 11 11 10 10 10 10 10 11 11 11 10 10 10 10 10 10 10 10 10 10 10 10
10 10 10 10 10 10 10 10 10 10 10 10 10 10 10 10 10 10 10 11 11 10 10 10 10 10 10 11 11 11 10 10 10 10 11 11 11 11 10 10 10 10 10 10 10 10 10 10 10 10
10 10 10 10 10 10 10 10 10 10 10 10 10 10 10 10 10 10 10 11 10 10 10 10 10 10 11 12 12 11 10 10 10 11 11 11 10 10 10 10 10 10 10 10 10 11 10 10 10 10
10 10 10 10 10 10 11 11 11 10 10 10 11 11 11 10 10 10 10 11 10 10 10 10 10 10 11 12 12 11 10 10 10 10 11 10 10 10 10 11 10 10 10 10 10 10 10 10 10 10
11 10 10 10 10 11 11 12 12 11 11 11 12 12 12 11 10 10 11 11 10 10 10 10 10 10 11 12 12 11 10 10 10 10 10 10 10 10 10 10 10 10 10 10 10 10 10 10 10 10
12 11 10 10 11 11 11 12 12 12 12 12 12 13 12 12 11 11 11 11 11 10 10 10 10 11 11 12 12 11 10 10 10 10 10 10 10 10 10 10 10 10 10 10 10 10 10 10 10 11
12 11 11 11 11 11 11 11 11 12 12 12 12 12 12 12 12 12 11 11 11 11 11 11 11 11 11 11 11 11 10 10 10 11 11 10 10 10 10 10 10 10 10 10 10 10 10 11 11 12
11 10 10 11 11 10 10 10 10 11 11 11 11 11 11 11 11 11 11 11 11 11 11 12 11 11 10 10 11 11 10 10 10 11 11 11 10 10 10 10 10 10 10 10 10 10 11 11 11 11
10 10 10 10 11 10 10 10 10 10 10 10 10 10 10 10 10 10 10 10 10 10 11 11 11 10 10 10 10 11 10 10 10 10 11 10 10 10 10 10 10 11 10 10 10 10 11 11 11 10
10 10 10 10 11 10 10 10 10 10 10 10 10 10 10 10 10 10 10 10 10 10 10 10 10 10 10 10 10 10 10 10 10 10 10 10 10 10 10 10 11 11 11 10 10 10 11 11 10 10
10 10 10 10 11 10 10 10 10 10 10 10 10 10 10 10 10 10 10 10 10 10 10 10 10 10 10 10 10 10 10 10 10 10 10 10 10 10 10 10 10 11 11 11 10 11 11 11 11 10
10 10 10 10 11 10 10 10 10 10 10 10 10 10 10 10 10 10 10 10 10 10 10 11 10 10 10 10 10 10 10 10 10 11 10 10 10 10 10 10 10 10 11 11 11 11 11 11 11 10
11 10 10 11 11 10 10 10 10 10 10 10 10 10 10 10 10 10 10 10 10 10 11 11 11 10 10 10 10 10 10 10 11 11 11 10 10 10 10 10 10 10 11 11 11 11 11 11 11 11
10 10 10 10 11 10 10 10 10 11 10 10 10 10 11 10 10 10 10 10 10 11 12 12 11 10 10 10 10 10 10 11 12 12 11 10 10 10 10 10 10 11 11 11 10 10 10 10 10 10
10 10 10 10 10 10 10 10 11 11 11 10 10 11 11 10 10 10 10 10 11 11 12 12 11 10 10 10 10 10 11 12 12 12 11 10 10 10 10 10 11 12 11 10 10 10 10 10 10 10
10 10 10 10 10 10 10 10 11 12 12 11 11 11 11 10 10 10 10 10 10 11 11 11 10 10 10 10 10 10 11 12 13 12 11 11 10 10 10 11 12 12 11 10 10 10 10 10 10 10
10 10 10 10 10 10 10 10 12 12 12 12 12 11 11 10 10 10 10 10 10 10 10 10 10 10 10 10 10 10 11 12 12 12 11 11 11 11 11 12 12 12 11 10 10 10 10 10 10 10 
11 11 10 10 10 10 10 11 11 11 11 11 11 11 11 10 10 10 10 10 10 10 10 10 10 10 10 10 10 10 10 11 12 11 11 11 11 11 11 11 11 11 10 10 10 10 10 10 11 10
10 11 10 10 10 10 11 11 11 10 10 10 11 11 11 10 10 10 10 10 10 10 10 10 10 10 11 10 10 10 10 11 11 11 10 10 10 10 10 10 10 10 10 10 10 10 10 11 11 11
10 10 10 10 10 11 11 11 11 10 10 10 10 11 11 10 10 10 10 11 11 11 10 10 10 10 10 10 10 10 10 11 11 10 10 10 10 10 10 10 10 10 10 10 11 11 11 11 11 11
10 10 10 10 10 11 12 12 11 10 10 10 10 10 10 10 10 10 10 11 11 11 10 10 10 10 10 10 10 10 10 10 10 10 10 10 10 10 10 10 10 10 10 11 11 11 11 11 10 10
10 10 10 10 10 11 11 12 11 11 10 10 10 10 10 10 10 10 11 11 11 10 10 10 10 10 10 10 10 10 10 10 11 11 10 10 10 10 10 10 10 10 10 11 11 11 10 10 10 10
11 10 10 10 10 10 11 11 11 11 11 11 10 10 10 10 10 10 11 11 10 10 10 10 11 10 10 10 10 10 10 10 11 11 11 10 10 10 10 10 10 10 11 12 11 10 10 10 10 10
10 10 10 10 10 10 11 11 11 10 10 10 10 10 10 10 10 11 11 11 10 10 10 10 11 10 10 10 10 10 10 11 12 12 11 10 10 10 10 10 10 11 12 12 11 10 10 10 10 10
10 10 10 10 10 10 11 11 10 10 10 10 10 10 11 11 11 11 11 11 10 10 10 10 11 10 10 10 10 10 11 11 12 12 11 10 10 10 10 10 11 12 12 12 11 10 10 10 10 10
10 10 10 10 10 11 11 11 10 10 10 10 10 11 11 11 11 11 10 10 10 10 10 11 11 11 10 10 10 10 10 11 11 11 10 10 10 10 10 11 11 11 11 11 10 10 10 10 10 10
10 10 10 10 10 11 12 11 10 10 10 10 11 12 11 11 10 10 10 10 10 10 10 11 11 11 11 10 10 10 10 10 10 10 10 10 10 10 10 11 11 10 10 10 10 10 10 10 10 10
10 10 10 10 10 11 11 11 10 10 10 11 12 12 11 10 10 10 10 10 10 10 10 10 11 11 11 10 10 10 10 10 10 10 10 10 10 10 11 11 10 10 10 10 10 10 10 10 10 10
10 10 10 10 10 10 11 10 10 10 10 11 12 12 11 10 10 10 10 10 10 10 10 10 10 10 10 10 10 10 10 10 10 10 10 10 10 11 11 11 10 10 10 10 10 10 11 10 10 10
10 10 10 10 10 10 10 10 10 10 10 11 12 12 11 10 10 10 10 11 11 11 10 10 10 10 10 10 10 11 11 11 11 11 11 11 11 11 11 11 10 10 10 10 10 11 11 11 10 10
11 10 10 10 10 10 10 10 10 10 10 10 11 11 11 10 10 10 10 11 11 11 10 10 10 10 10 10 11 11 12 12 13 13 12 12 12 11 11 10 10 10 10 10 10 10 11 11 10 10
11 11 10 10 10 10 10 10 10 10 10 10 10 11 11 10 10 10 11 11 11 10 10 10 10 10 10 10 11 11 12 13 13 13 13 12 11 10 10 10 10 10 10 10 10 10 10 10 10 10
11 11 11 11 11 11 11 10 10 10 10 10 10 11 11 10 10 10 10 11 10 10 10 10 10 11 10 10 10 10 11 12 13 13 12 11 10 10 10 10 10 11 11 10 10 10 10 10 10 10
10 10 10 10 10 10 10 10 10 10 10 10 11 11 11 10 10 10 10 11 10 10 10 10 10 10 10 10 10 10 10 11 12 12 11 10 10 10 10 10 10 11 11 11 10 10 10 11 11 11
10 10 10 10 10 10 10 10 10 10 11 11 11 11 11 10 10 10 10 11 10 10 10 10 10 10 10 10 10 10 10 10 11 11 10 10 10 10 10 10 10 11 11 11 11 11 11 12 12 12
10 10 10 10 10 10 10 10 10 10 10 10 11 11 11 10 10 10 10 11 11 10 10 10 10 10 10 10 10 10 10 10 10 10 10 10 10 10 10 10 11 11 12 12 12 12 12 13 13 13
10 10 10 10 10 10 10 10 10 10 10 10 11 11 11 10 10 10 10 11 11 11 11 10 10 10 10 10 10 10 10 10 10 10 10 10 10 10 10 11 11 11 11 11 11 12 13 13 13 12 
10 10 10 10 10 10 10 10 10 10 10 10 10 11 11 10 10 10 10 10 11 11 12 11 10 10 10 10 10 10 10 10 10 10 10 10 10 10 10 10 11 11 10 10 10 11 12 12 12 11
10 10 10 10 10 10 10 10 10 10 10 10 11 11 11 10 10 10 10 10 10 11 12 12 11 10 10 10 1 10 10 11 10 10 10 10 11 10 10 10 10 10 10 10 10 10 10 10 11 11 11 10
10 10 10 10 11 11 11 11 11 11 11 11 11 11 11 10 10 10 10 10 10 10 11 12 11 11 10 10 10 10 10 10 10 10 11 10 10 10 10 10 10 10 10 10 10 10 10 10 10 10
10 10 10 11 12 12 12 11 11 12 12 12 12 12 11 11 10 10 10 10 10 10 10 11 11 10 10 10 10 10 10 10 10 11 11 10 10 10 10 10 10 10 10 10 10 10 10 10 10 10
10 10 10 11 12 12 11 11 11 11 12 12 12 11 11 11 11 10 10 10 10 10 10 10 10 10 10 10 10 10 10 10 10 11 11 10 10 10 10 10 10 10 10 10 10 10 10 10 10 10
10 10 10 11 11 11 10 10 10 10 11 11 11 11 10 11 11 10 10 10 10 10 10 10 10 10 10 10 10 10 10 10 11 12 11 10 10 10 10 10 10 10 10 10 10 10 10 10 11 10