55555555555555555555555555555555555555555555555555
55555555555555555555555555555555555555555555555555
55555555555555555555555555555555555555555555555555
55555555555555555555555555555555555555555555555555
55555555555555555555555555555555555555555555555555
55555555555555555555555555555555555555555555555555
55555555555555555555555555555555555555555555555555
55555555555555555555555555555555555555555555555555
55555555555555555555555555555555555555555555555555
55555555555555555555555555555555555555555555555555
55555555555555555555555555555555555555555555555555
55555555555555555555555555555555555555555555555555
55555555555555555555553333555555555555555555555555
55555555555555555555533333355555555555555555555555
55555555555555555555333113333333555555555555555555
55555555555555555555331111111133311115555555555555
55555555555555555553331111611111111111555555555555
55555555555555555553311116611110000011155555555555
55555555555555555511111111111110000011115555555555
55555555555555555111114444411110050011111555555555
55555555555555551111114000411110000011115555555555
55555555555555511111114000411110000011115555555555
55555555555555111111114000411111111111155555555555
55555555555555111111114000411111111111155555555555
55555555555555111111114424411111111111555555555555
55555555555555111111111121111111111111555555555555
55555555555555111161111111111111161111555555555555
55555555555555511111111111111111111111555555555555
55555555555555511111161111111111111111555555555555
55555555555555511111111111111111151111555555555555
55555555555555511111111111111155551115555555555555
55555555555555551111116611111555555155555555555555
55555555555555551111111111155555555555555555555555
55555555555555555111111111155555555555555555555555
55555555555555555511555115555555555555555555555555
55555555555555555555555555555555555555555555555555
55555555555555555555555555555555555555555555555555
55555555555555555555555555555555555555555555555555
55555555555555555555555555555555555555555555555555
55555555555555555555555555555555555555555555555555
55555555555555555555555555555555555555555555555555
55555555555555555555555555555555555555555555555555
55555555555555555555555555555555555555555555555555
55555555555555555555555555555555555555555555555555
55555555555555555555555555555555555555555555555555
55555555555555555555555555555555555555555555555555
55555555555555555555555555555555555555555555555555
55555555555555555555555555555555555555555555555555
55555555555555555555555555555555555555555555555555
55555555555555555555555555555555555555555555555555
