44444444444444444444444444444444444444444444444444
44444444444444444444444444444444444444444444444444
44444444444444444444022222044444444444444444444444
44444444444444444444222222244444444444444444444444
44444444444444444444222222244444444444444444444444
44444444444444444444222222244444444444444444444444
44444444111114444444422222444444444444444444444444
44444444133314444444000500044444405555555444444444
44444444133314444444400000444444445555555544444444
44444444133314444444440004444444445555555544444444
44444444133314444444444544444444445555555544444444
44444444110114444444444544444444445555555544444444
44444444440444444444444544444444444555555444444444
44444444440444444444444544444444444444544444444444
44444444440444444444444544444444444444544444444444
44444444440444444444444544444444444444544444444444
44444444000444444444444544444444444444544444444444
44444444024444444444444544444444444444544444444444
44444444044444444444440504444444444455544444444444
44444444044444444444400500444444444454444444444444
44444444044444444444000500044444444554444444444444
44444444044455555555555555555555555554444444444444
44444444044404444444000500044444444454444444444444
44444444044404444444400500444444444454444444444444
44444444044404444444440504444444444454444444444444
44444444044400044444444544444444444454444444444444
44444444044444044444444544444444444454444444444444
44444444044444044444444544404444444054444444444444
44444444044444044444444544444404444454444444444444
44444444000000044444444544444404444454444444444444
44444444000000044444444544444444444404444444444444
44444444000000044444444544444444444000444444444444
44444444000000044444444544444444444000444444444444
44444444000000044444444544444444444000444444444444
44444444000000044444444544444444444000444444444444
44444444444444444444444544444444444000444444444444
44444444444444444440000000044444440000044444444444
44444444444444444400000000004404400000044444444444
44444444444444444400000000004444000000044444444444
44444444444440444400000000000444000004044444444444
44444444444444444400000000000000004000044444444444
44444444444440444440000000044440000000044444444444
44444444444444444444000000444440040040044444444444
44444444444444444444444444444444000000444444444444
44444444444444444444444444444444444444444444444444
44444444444444444444444444444444444444444444444444
44444444444444444444444444444444444444444444444444
44444444444444444444444444444444444444444444444444
44444444444444444444444444444444444444444444444444
44444444444444444444444444444444444444444444444444